4 4 4 4 4 8 4 4 4 4 4 4 4 4 4 4
4 4 4 4 4 4 4 4 4 3 9 4 4 4 7 4
4 4 3 4 4 4 4 4 4 4 4 4 4 4 4 4
4 4 4 4 4 4 4 4 4 4 4 4 4 4 4 4
4 4 9 4 4 3 4 4 4 8 4 4 3 4 4 4
4 4 4 4 4 4 4 4 9 4 4 4 4 4 4 4
8 4 4 4 8 4 4 4 4 4 4 4 4 4 4 4
4 4 4 4 4 4 4 3 4 4 4 4 4 4 4 4
4 4 3 4 4 4 4 4 4 4 4 4 4 4 3 4
4 4 4 9 4 4 4 4 4 3 4 4 4 8 4 4
4 8 4 4 4 4 4 4 4 4 4 4 4 4 4 4
4 4 4 4 3 4 4 8 4 4 4 3 4 9 4 4